***************
*.............*
*..**.........*
*..**.........*
*.............*
*.............*
*.........**..*
*.........**..*
*.............*
***************