***************
*.............*
*.............*
*....**********
*.............*
*.............*
**********....*
*.............*
*.............*
***************