***************
*.............*
****.......****
*.............*
*.....***.....*
*.....***.....*
*.............*
****.......****
*.............*
***************